###############
#.............#
#.............#
#.............#
#.............#
#.............#
#.............#
#......P......#
#.............#
#.............#
#.............#
#.............#
#.............#
#.............#
###############